rat 1 2
cheese 6 7
 _ _ _ _ _ _ _ _
| |_     _ _ _  |
|  _|_  |  _ _ _|
|   | | |_ _ _  |
|  _ _| |       |
|  _ _  |  _ _ _|
|_ _  | |_ _    |
|  _ _|_ _ _|_  |
|   |           |
 _ _ _ _ _ _ _ _
